#####################
#.........#.........#
#.##.####.#.####.##.#
#.##.##.......##.##.#
#.......#.#.#.......#
###.#.###...###.#.###
....#...#####...#....
###.###...#...###.###
#.......#...#.......#
#####################